[console_scripts]
termius = termius.main:main

[termius.handlers]
connect = termius.handlers:ConnectCommand
crypto = termius.cloud.commands:CryptoCommand
export-ssh-config = termius.porting.commands:SSHExportCommand
fullclean = termius.cloud.commands:FullCleanCommand
group = termius.handlers:GroupCommand
groups = termius.handlers:GroupsCommand
host = termius.handlers:HostCommand
hosts = termius.handlers:HostsCommand
identities = termius.handlers:IdentitiesCommand
identity = termius.handlers:IdentityCommand
import-hosts = termius.porting.commands:ImportHostsCommand
import-ssh-config = termius.porting.commands:SSHImportCommand
info = termius.handlers:InfoCommand
init = termius.handlers:InitCommand
key = termius.handlers:SshKeyCommand
keys = termius.handlers:SshKeysCommand
login = termius.account.commands:LoginCommand
logout = termius.account.commands:LogoutCommand
pfrule = termius.handlers:PFRuleCommand
pfrules = termius.handlers:PFRulesCommand
pull = termius.cloud.commands:PullCommand
push = termius.cloud.commands:PushCommand
settings = termius.account.commands:SettingsCommand
snippet = termius.handlers:SnippetCommand
snippets = termius.handlers:SnippetsCommand
tags = termius.handlers:TagsCommand

[termius.info.formatters]
json = cliff.formatters.json_format:JSONFormatter
shell = cliff.formatters.shell:ShellFormatter
ssh = termius.formatters.ssh:SshFormatter
table = cliff.formatters.table:TableFormatter
value = cliff.formatters.value:ValueFormatter
yaml = cliff.formatters.yaml_format:YAMLFormatter

[termius.sync.providers]
ssh = termius.sync.providers.ssh:SSHService

